9
8
21 2 0 0 0 0 0 1 21
22 4 0 0 0 0 0 3 22
22 4 0 0 0 0 0 3 22
22 4 0 0 0 0 0 3 22
22 4 0 0 0 0 0 3 22
22 4 0 0 0 0 0 3 22
22 4 0 0 0 0 0 3 22
5 21 21 21 21 21 21 21 6
